
     #####
   ###...#
   #O@B..#
   ###.BO#
   #O##B.#
   #.#.O.##
   #B.BB.O#
   #...O..#
   ########
